1 1 1 1 1 1 1 1 1 1 1 1 1 1 1 1 1 1 1 1 1 1 1 1 1 1 1 1 1 1 1 1 1 1 1 1 1 1 1 1
1 0 0 5 0 0 0 0 2 6 2 0 2 6 2 0 0 2 6 2 0 0 0 0 0 2 6 2 0 0 0 0 7 3 7 0 4 0 7 1
1 0 0 0 0 0 0 0 0 2 0 0 0 2 0 2 0 0 2 7 0 0 7 0 0 0 2 0 0 0 0 0 0 7 0 0 0 7 3 1
1 5 0 5 0 4 0 0 0 0 0 0 0 2 2 6 2 4 7 3 7 7 3 7 0 0 0 0 0 5 0 0 0 0 0 0 0 0 7 1
1 0 0 0 0 0 0 0 0 0 0 0 2 6 2 2 6 2 0 7 0 0 7 0 0 0 0 2 0 0 7 0 0 2 0 0 0 0 0 1
1 0 0 2 0 0 0 7 0 0 0 0 0 2 0 0 2 0 0 0 0 5 0 0 0 0 2 6 2 7 3 7 2 6 2 0 0 0 0 1
1 0 2 6 2 0 7 3 7 0 5 0 0 7 4 0 0 0 0 0 0 0 0 0 0 0 0 2 0 0 7 0 0 2 0 0 0 0 0 1
1 0 0 2 0 0 0 7 0 0 0 0 7 3 7 0 0 5 0 0 0 0 0 0 2 0 0 0 0 0 0 0 0 0 0 0 2 0 0 1
1 0 0 0 5 0 0 0 0 0 2 0 0 7 0 0 0 0 0 0 0 0 0 2 6 2 0 0 0 0 0 0 0 0 0 2 6 2 0 1
1 4 0 0 0 0 5 0 0 2 6 2 0 0 0 2 0 0 0 0 0 2 0 4 2 0 5 0 0 0 0 4 0 0 0 0 2 0 0 1
1 0 0 0 2 0 0 0 0 0 2 0 0 0 2 6 2 0 0 0 2 6 2 0 0 0 0 0 2 0 0 0 0 0 0 4 0 0 0 1
1 0 0 2 6 2 5 4 0 0 0 0 0 0 0 2 0 0 0 0 0 2 0 0 5 0 0 2 6 2 0 0 0 2 0 0 5 0 0 1
1 0 5 0 2 0 0 0 0 4 0 2 0 0 0 0 0 5 0 0 0 0 0 0 0 0 0 0 2 5 0 0 2 6 2 0 0 0 0 1
1 0 0 0 0 0 4 0 0 0 2 6 2 0 7 0 0 0 0 0 0 0 0 0 0 2 0 0 0 0 0 4 0 2 0 0 0 4 0 1
1 0 0 0 0 2 0 0 2 0 0 2 0 7 3 7 0 0 0 0 0 0 0 0 2 6 2 0 0 0 0 0 0 0 0 0 2 0 0 1
1 0 2 0 2 6 2 2 6 2 0 0 0 0 7 0 0 0 4 0 2 0 0 0 0 2 0 0 0 2 0 0 0 0 0 2 6 2 0 1
1 2 6 2 5 2 0 0 2 0 0 0 0 0 4 0 0 2 0 2 6 2 0 0 0 0 5 0 2 6 2 0 0 0 2 0 2 0 0 1
1 0 2 0 0 0 0 5 0 0 2 0 0 0 5 0 2 6 2 0 2 0 4 0 0 5 0 0 0 2 0 0 0 2 6 2 0 0 0 1
1 0 0 0 5 0 0 5 0 2 6 2 0 0 0 0 0 2 6 2 0 0 0 0 0 0 4 0 0 0 0 5 0 0 2 0 0 0 4 1
1 1 1 1 1 1 1 1 1 1 1 1 1 1 1 1 1 1 1 1 1 1 1 1 1 1 1 1 1 1 1 1 1 1 1 1 1 1 1 1
